1111111
1110C11
1P00111
1010C11
1C1E111
1000011
100C111
1111111