1111111
1110C01
1P001C1
1010C11
1C10111
10000C1
100C111
11111E1
1111111