111111
1110C1
1P0011
1010C1
1C1E11
111111