1111111
1110C01
1P001C1
1010C11
1C1E111
10000C1
100C111
1111111