1111111111111
1111C001100C1
11C1110C001C1
11011C01001C1
1C001011001C1
1P000C1C101C1
1E0C1110000C1
1111111111111