1111111111111
1110C01110C01
1P001C00001C1
1010C11C00101
1C1E111100C01
10000C0001011
100C11100C0C1
1111111111111