11111111111111111111111111111111
1110C01110C00010C001C1C1C1C1C111
1P001C00001C11011101000000000111
1010C11C001011C11101100111111111
1C1E111100C011011100C001000C0001
10000C00010111011100000101010101
100C11100C0C0000000C000101010101
11000C00001111100C111C0101010101
11000011C0C011100C1110000C000011
1110111110000C0010C0001111110111
1C1010C01011110010C0001C11C10001
100C100000111C0010001C10000000C1
11111111111111111111111111111111